111111111111111111111111111111
100011000C00001110C001110C00C1
1C00C00000CP1110C0C01110000C11
1C0C0C001C000C0C0C00C0C0C0C001
100011100C00C0C0C00C0C00000C01
100C0C0010000110000010C0C0C001
100011000C0C000C000C0C000C0001
100000C0000000110000000C00C001
1C0C0C0C0C0C0C0C0C0C0C0C0C0C01
100000C0C000C0C0C00C0C0000C0C1
10000001100C0C0C0C00C0C0000001
1C0C0C0000000C0000C000C0C0C001
1C000C0C0C0C000000C0C000C0C001
100C0C00E00C0000C0C0000C0C0C01
1C00000000C0C0C0C0C0C000000001
111111111111111111111111111111
