11111111111111
1E00000C000001
11111000001001
10000000101011
1P0C00000C00C1
10000000000001
11111111111111
