11111111111111111
10000C000C000C001
10000000000000001
100C0C000C0C0C001
10000000000000001
1C0C0C000C0C0C001
1000000E000000001
100C0C0C0C0C0C001
10000000000000001
100C0C000C0C0C001
100C000C000C00001
100C0000000000001
100C0C0C0C0C0C001
1000000P000000001
11111111111111111
