11111111111111111111
1P0000C0000000000011
11111111111111110111
100000C0000000000001
10011111111111110001
100100000C000011C001
100100000000C0110001
10010011111111110001
10010010000000000001
10010010000000000C01
1C010010011111111111
10010010010000000001
10000010010000000001
10010010010011101111
10010010000010000001
100100100100100C0E11
11111111111111111111
