1111111111111
1P0C000C01011
1110111111101
1C00000C00011
1001111111001
1000C00000001
1000C01111101
1000000000001
1000000000001
1011111011111
1000000000001
1001111111111
100C0000000E1
1111111111111
