11111111111111111111
1P00C00010000C000011
11101111111011111011
10000000000000000001
10111111111111111101
1000C000000000C00001
10111111111011111101
100000C0000000000001
11000011111111111111
1C000000C00000000E11
11111111111111111111
