111111111111111111111
1000000C0C0C00C000011
100000001111110000111
100C0C0000000C0C0C001
100000011111100000001
111111100000001111111
100C0000111111000C001
1000000000000C0000001
100C000000C0000C00001
100C000000C0000C00001
1000C00E00PC0000C0001
100000111111110000001
100000000000000000001
100000011101110011101
100C000000C000C000011
111111111111111111111
